11111111111111111
10M100010CM0011C1
10010000000C01C01
100000M0000000001
100C01111110011M1
1P0011E0000000001
11111111111111111