1111111111111
1C0100010C001
10010100000C1
100C011111001
1P0011E000001
1111111111111